R 1600 800
NO testermaps/textures/wall_1.xpm
SO testermaps/textures/wall_2.xpm
WE testermaps/textures/wall_3.xpm
EA testermaps/textures/wall_4.xpm
S testermaps/textures/sprite_1.xpm
F 184,113,39
C 51,198,227

111111111111111111
102000000000000001
1N0000000000011111
10000020000001
102000000000011101
100000000000000001
111111111111111111