R                2000               3000                 
EA testermaps/textures/air.xpm
NO testermaps/textures/fire.xpm
WE testermaps/textures/earth.xpm
SO testermaps/textures/water.xpm
S testermaps/textures/evil_sprite.xpm
F                    184,                  113,                  39   
C                  51,                  198                 227   

1111111111111
1020000000021
1E00000000001
1000002000001
1111111111111
