R 1600 800
NO testermaps/textures/wall_1.xpm
SO testermaps/textures/wall_2.xpm
WE testermaps/textures/wall_3.xpm
EA testermaps/textures/wall_4.xpm
S testermaps/textures/sprite_1.xpm
F 184,113,39
C 51,198,227  


1111111101111
1020000000021
1E00000000001
1000002000001
1111111111111
