R 1600 800
EA testermaps/textures/air.xpm
NO testermaps/textures/fire.xpm
WE testermaps/textures/earth.xpm
SO testermaps/textures/water.xpm
S testermaps/textures/sprite_1.xpm
F 184,113,39
C 51,198,227

1111111111111111111111111111111111111111111111
1020000000020000000000000000000000000000000001
100N000000000000000000000000000000000000000001
1000002000000000000000000000000000000000000001
1000000000000000000000000000000000000000000001
1000000000000000000000000000000000000000000001
1000000000000000000000000000000000000000000001
1000000000000000000000000000000000000000000001
1000000000000000000000000000000000000000000001
1000000000000000000000000000000000000000000001
1000000000000000000000000000000000000000000001
1000000000000000000000000000000000000000000001
1000000000000000000000000000000000000000000001
1000000000000000000000000000000000000000000001
1000000000000000000000000000000000000000000001
1000000000000000000000000000000000000000000001
1000000000000000000000000000000000000000000001
1000000000000000000000000000000000000000000001
1000000000000000000000000000000000000000000001
1000000000000000000000000000000000000000000001
1000000000000000000000000000000000000000000001
1000000000000000000000000000000000000000000001
1000000000000000000000000000000000000000000001
1000000000000000000000000000000000000000000001
1111111111111111111111111111111111111111111111
