R 1600 800 F 184,113,39 C 51,198,227
EA testermaps/textures/air.xpm
NO testermaps/textures/fire.xpm
WE testermaps/textures/earth.xpm
SO testermaps/textures/water.xpm
S testermaps/textures/sprite 3.xpm



1111111111111
102000000002111
10E000000000101
100000200000111
1111111111111
