R 2000 3000
WE testermaps/textures/air.xpm
NO testermaps/textures/fire.xpm
EA testermaps/textures/evil_sprite.xpm
SO testermaps/textures/water.xpm
S testermaps/textures/sprite 3.xpm
F 184,113,39   
C 51,198,227   

1111111111111
1020000000021
1E00000000001
1000002000001
1111111111111
