R 1600 800
NO textures/wall_1.xpm
SO textures/wall_2.xpm
WE textures/wall_3.xpm
EA textures/wall_4.xpm
S textures/sprite_1.xpm
F 184,113,39
C 51,198,227

1111111111111
1020000000021
1000000000001
1000002000001
1111111111111