R 1600 800
EA testermaps/textures/air.xpm
NO testermaps/textures/fire.xpm
WE testermaps/textures/earth.xpm
SO testermaps/textures/wall_1.xpm
S testermaps/textures/sprite 3.xpm
F 184,113,39
C 51,198,227

        1111111111111111111111111
        1000000000110000000000S01
        1011000001110000000000001
        1001000000000000000000001
111111111011000001110000000000001
100000000011000001110111111111111
11110111111111011100000010001
11110111111111011101010010001
11000000110101011100000010001
10000000000000001100000000001
10000000000000001101010010001
1100000111010101111101111000111
11110111 1110101 101111010001
11110111 1111111 111111111111
   101    
   101111111111111111111111111111
   100000000000000110000000000001
   111111011000001110000000000001
        1001000000000000000000001
111111111011000001110000000000001
100000000011000001110111111111111
11110111111111011100000010001
11110111111111011101010010001
11000000110101011100000010001
10000000000000001100000000001
10000000000000001101010010001
1100000111010101111101111000111
11110111 1110101 101111010201
11111111 1111111 111111111111